  

  1----------2            1----------2
  l....B.....r            l..........r
  l..........r            l...*...*..r
  l..........r------------l..........r
  l......!t..o...........o.....*.*..*r
  l..........r____________l..........r
  l..........r            l.....*..*.r
  l...@......r            l..........r
  3__________4            3__________4
